EEEEEEEEEEEEEEEEEEE
EEEEEEEEEEEEEEEEEEE
EEEEEEEEEEEEEEEEEEE
ZZZZZZZZZZZZZZZZZZZ
ZZZZZZZZZZZZZZZZZZZ
ZZZZZZZZZZZZZZZZZZZ
ZZZZZZZZZZZZZZZZZZZ
ZZZZZZZZZZZZZZZZZZZ
ZZZZZZZZZZZZZZZZZZZ
ZZZZZZZZZZZZZZZZZZZ
ZZZZZZZZZZZZZZZZZZZ
ZZZZZZZZZZZZZZZZZZZ
ZZZZZZZZZZZZZZZZZZZ
ZZZZZZZZZZZZZZZZZZZ
ZZZZZZZZZZZZZZZZZZZ
ZZZZZZZZZZZZZZZZZZZ
ZZZZZZZZZZZZZZZZZZZ
ZZZZZZZZZZZZZZZZZZZ
ZZZZZZZZZZZZZZZZZZZ
ZZZZZZZZZZZZZZZZZZZ
ZZZZZZZZZZZZZZZZZZZ
ZZZZZZZZZZZZZZZZZZZ
ZZZZZZZZZZZZZZZZZZZ
ZZZZZZZZZZZZZZZZZZZ
ZZZZZZZZZZZZZZZZZZZ
EEHHHEEEEEEEEEEEEEE