EEEEEEEEEEEEEEEEEEE
EEEEEEEEEEEEEEEEEEE
EEEEEEEEEEEEEEEEEEE
WWZZZZZZZZZZZZZZZWW
WZZZZZZZZZZZZZZZZZW
ZZZZZZZZZZZFZZZZZZZ
ZZZZZZZZZZZZZZZZZZZ
ZZZZZZZZZZZZZZZZZZZ
ZZZZZZZZZZZZZZZZZZZ
ZZZZZZZZZZZZZZZZZZZ
ZZZZZZZZZZZZZZZZZZZ
ZZZZZZZZZZZZZZZZZZZ
ZZZZZZZWWBWWZZZZZZZ
ZZZZZZZWIPCWZZZZZZZ
ZZZZZZZWWWWWZZZZZZZ
ZZZZZZZZZZZZZZZZZZZ
ZZZZZZZZZZZZZZZZZZZ
ZZZZZZZZZZZZZZZZZZZ
ZZZZZZZZZZZZZZZZZZZ
ZZZZZZZZZAZZZZZZZZZ
ZZZZZZZZZZZZZZZZZZZ
ZZZZZZZZZZZZZZZZZZZ
ZZZZZZZZZZZZZZZZZZZ
WZZZZZZZZZZZZZZZZZW
WWZZZZZZZZZZZZZZZWW
EEHHHEEEEEEEEEEEEEE