EEEEEEEEEEEEEEEEEEE
EEEEEEEEEEEEEEEEEEE
EEEEEEEEEEEEEEEEEEE
WWWWWWWWWWWWWWWWWWW
WSFFFFFFFWFFFFFFFSW
WFWWFWWWFWFWWWFWWFW
WFWWFWWWFWFWWWFWWFW
WFFFFFFFFFFFFFFFFFW
WFWWFWFWWWWWFWFWWFW
WFFFFWFFFWFFFWFFFFW
WWWWFWWWFWFWWWFWWWW
EEEWFWFFFFFFFWFWEEE
WWWWFWFWWBWWFWFWWWW
FFFFFFFWIPCWFFFFFFF
WWWWFWFWWWWWFWFWWWW
EEEWFWFFFFFFFWFWEEE
WWWWFWFWWWWWFWFWWWW
WFFFFFFFFWFFFFFFFFW
WFWWFWWWFWFWWWFWWFW
WFFWFFFFFAFFFFFWFFW
WWFWFWFWWWWWFWFWFWW
WSFFFWFFFWFFFWFFFSW
WFWWWWWWFWFWWWWWWFW
WFFFFFFFFFFFFFFFFFW
WWWWWWWWWWWWWWWWWWW
EEHHHEEEEEEEEEEEEEE