EEWEEEEEEEEEEEEEWEE
EEWWWWEWWEWWEWWWWEE
EEEEEWEWEEEWEWEEEEE
EEWWWWEWWWWWEWWWWEE
EEEEEEEEEEEEEEEEEEE
EEEEEEEEEEEEEEEEEEE
EEEEEEEEEEEEEEEEEEE
EEEEEEEEEEEEEEEEEEE
EEEEEEEEEEEEEEEEEEE
EEEEEEEEEEEEEEEEEEE
EEEEEEEEEEEEEEEEEEE
EEEEEEEEEEEEEEEEEEE
EEEEEEEEEEEEEEEEEEE
EEEEEEEEEEEEEEEEEEE
EEEEEEEEEEEEEEEEEEE
EEEEEEEEEEEEEEEEEEE
EEEEEEEEEEEEEEEEEEE
EEEEEEEEEEEEEEEEEEE
EEEEEEEEEEEEEEEEEEE
EEEEEEEEEEEEEEEEEEE
EEEEEEEEEEEEEEEEEEE
EEEEEEEEEEEEEEEEEEE
EEWEEEEEEEEEEEEEWEE
EEWEWWWWEWEWWWWEWEE
EEWEEEEEEWEEEEEEWEE
EEWWWWEWWWWWEWWWWEE