EEEEEEEEEEEEEEEEEEE
EEEEEEEEEEEEEEEEEEE
EEEEEEEEEEEEEEEEEEE
EEEEEEEEEEEEEEEEEEE
EEEEEEEEEEEEEEEEEEE
EEEEEEEEEEEEEEEEEEE
EEEEEEEEEEEEEEEEEEE
EEEEEEEEEEEEEEEEEEE
EEEEEEEEEEEEEEEEEEE
EEEEEEEEEEEEEWWWWEE
EEEEEEEEEEEEEWIIWEE
EEEEEEEEEEEEEWIWWEE
EEEEEEEEEWWWWWIWEEE
EEEEEEEEEWEEEEIWEEE
EEEEEEEEEWEWWWIWEEE
EEEEEEEEEWEWWWWWEEE
EEEEEEEEEWEWWEEEEEE
EEEEEEEEEWEEWWWWWEE
EEEEEEEEEEWEEESAWEE
EEEEEEEEEEWWWWWWWEE
EEEEEEEEEEEEEEEEEEE
EEEEEEEEEEEEEEEEEEE
EEEEEEEEEEEEEEEEEEE
EEEEEEEEEEEEEEEEEEE
EEEEEEEEEEEEEEEEEEE
EEHHHEEEEEEEEEEEEEE